062 062 062 062 062 062 062 062 062 062 062
047 048 048 048 048 048 048 048 048 048 049
050 051 051 052 053 054 051 051 055 055 056
050 057 057 057 057 057 057 057 057 057 056
050 058 058 058 058 058 058 058 058 058 056
050 058 058 058 058 058 058 058 058 058 056
050 058 058 058 058 058 058 058 058 058 056
050 058 058 058 058 058 058 058 058 058 056
050 058 058 058 058 058 058 058 058 058 056
050 058 058 058 058 058 058 058 058 058 056
059 060 060 060 060 062 060 060 060 060 061
062 062 062 062 062 062 062 062 062 062 062
